1111111111111
10100000000C1
1000111111001
1P0011T110001
1000C0T0E0001
1111111111111
