111111111
10P000001
100000T01
100CC0E01
111111111
