1111111111111111111
1P00001000000000001
1011111011111111101
10C00000100000C1101
1011101010111110001
100110101010000T101
111010101011111T101
1000101000T00C10101
1011101111111010101
10000000000000100E1
1111111111111111111
