111111111111111
1P000C000000001
111111T11111101
100000000000101
10111111T110101
10100000C000101
101T0111111T101
10100000000C101
1011T111111T101
1000000000000E1
111111111111111
