1111111111111111111111111111111111111111
1P00000000000000000000000000000000000001
1011111111110111111111011111111101111101
100C000000010000000001000000000010000C01
1000011111010001111101000111110100011101
1000000001010000000101000000010100000001
1011111001010111100101011111010101111101
1C00000001010000000101010000010101000001
1011110101010111100101010111010101011101
1000100101010100C001010101000010101000C1
1000100101010101110101010111110101011111
1000100101010100000101010000000101010001
1000100101010111100101011111010101011101
1000100101010000000101000000010101000001
1000100101010111110101111111010101111101
1000100001010000000000000000C0010100C001
1000101111010111111111111111101010111101
1000100000010100000000000000000010000101
1000101111101011111111111111010101111101
1000100000001010000C000000000C00100C0001
1000101111111010111111111111010101111101
1000100000000010000000000000010101000001
1000111111111101111111111111101010111101
1C00000000000000000000000000000000000E01
1111111111111111111111111111111111111111
