11111111111111111111111111
1P0000000000000000000C0011
10111111111T11111111111T11
100C00000000000T00000000E1
1T111111111011111111111101
1000000000101000000000C001
11111111111010111111111111
1C00T0000010000T0000000011
101111111T1011111T11111101
100000000000000000000000C1
11111111111111111111111111
