11111111111111111
1P000000T0000C001
10111111111111101
100T000000000T001
101111T0T0T111101
10C00000E00000C01
101111T0T0T111101
100T000000000T001
10111111111111101
1000C0T0000000001
11111111111111111
